{
  "version": 1,
  "source": "natural-earth",
  "polygons": [
    {
      "id": "honshu",
      "points": [
        2980, 1186, 2951, 1162, 2912, 1148, 2893, 1170, 2879, 1218, 2879, 1248, 2942, 1234, 2973,
        1221, 2982, 1229, 2987, 1258, 2980, 1288, 2954, 1317, 2912, 1301, 2898, 1304, 2879, 1331,
        2867, 1331, 2851, 1314, 2839, 1231, 2795, 1229, 2783, 1223, 2767, 1242, 2771, 1282, 2750,
        1336, 2727, 1352, 2699, 1357, 2673, 1392, 2673, 1411, 2694, 1470, 2685, 1515, 2661, 1555,
        2635, 1563, 2631, 1574, 2647, 1585, 2680, 1582, 2689, 1590, 2703, 1620, 2706, 1654, 2703,
        1697, 2694, 1724, 2671, 1759, 2645, 1853, 2633, 1877, 2593, 1928, 2570, 1981, 2551, 2051,
        2516, 2085, 2432, 2131, 2415, 2150, 2390, 2206, 2352, 2251, 2298, 2297, 2275, 2310, 2249,
        2316, 2202, 2340, 2109, 2369, 2069, 2417, 2048, 2423, 2018, 2417, 1994, 2399, 1994, 2367,
        1987, 2348, 1966, 2324, 1971, 2310, 2001, 2297, 2025, 2281, 2069, 2238, 2064, 2217, 2036,
        2222, 1980, 2246, 1952, 2254, 1924, 2302, 1931, 2369, 1919, 2425, 1887, 2471, 1840, 2527,
        1793, 2565, 1772, 2591, 1758, 2626, 1760, 2658, 1779, 2685, 1760, 2709, 1732, 2728, 1681,
        2757, 1662, 2752, 1599, 2749, 1575, 2733, 1585, 2715, 1585, 2699, 1561, 2691, 1493, 2715,
        1395, 2723, 1336, 2747, 1255, 2760, 1198, 2755, 1168, 2757, 1142, 2768, 1116, 2741, 1091,
        2741, 1035, 2755, 983, 2779, 964, 2808, 915, 2848, 880, 2886, 833, 2918, 786, 2964, 728,
        2993, 667, 3049, 646, 3055, 616, 3049, 585, 3055, 559, 3089, 566, 3164, 602, 3154, 639,
        3172, 697, 3154, 758, 3146, 840, 3196, 854, 3202, 857, 3175, 866, 3151, 875, 3097, 892,
        3073, 918, 3065, 943, 3081, 974, 3092, 999, 3089, 1058, 3071, 1086, 3079, 1102, 3068, 1159,
        3044, 1212, 3028, 1259, 3028, 1280, 3017, 1336, 2972, 1423, 2953, 1461, 2953, 1505, 2982,
        1531, 2990, 1568, 2985, 1606, 2985, 1620, 2993, 1610, 3025, 1585, 3057, 1545, 3081, 1554,
        3111, 1552, 3156, 1564, 3186, 1603, 3234, 1627, 3279, 1685, 3296, 1737, 3277, 1772, 3218,
        1819, 3135, 1833, 3111, 1882, 3089, 1940, 3079, 1954, 3073, 1961, 3044, 1901, 3001, 1879,
        2977, 1891, 2948, 1917, 2897, 1954, 2875, 1966, 2881, 1954, 2897, 1961, 2942, 1959, 2964,
        1975, 2966, 1973, 2939, 1992, 2942, 1997, 2953, 2055, 2953, 2057, 2972, 2008, 2993, 2004,
        3004, 2064, 2988, 2116, 2982, 2165, 2985, 2219, 2988, 2268, 2998, 2282, 2964, 2305, 2931,
        2343, 2894, 2359, 2867, 2392, 2859, 2415, 2865, 2434, 2883, 2411, 2899, 2411, 2923, 2401,
        2972, 2420, 2993, 2434, 2990, 2453, 2972, 2479, 2934, 2486, 2902, 2486, 2865, 2495, 2835,
        2516, 2816, 2568, 2811, 2589, 2827, 2607, 2854, 2617, 2851, 2631, 2824, 2614, 2806, 2610,
        2782, 2638, 2760, 2643, 2728, 2652, 2715, 2689, 2712, 2715, 2733, 2713, 2747, 2678, 2779,
        2671, 2798, 2652, 2811, 2657, 2830, 2652, 2873, 2654, 2889, 2645, 2902, 2654, 2915, 2673,
        2918, 2706, 2881, 2729, 2865, 2764, 2848, 2790, 2819, 2788, 2787, 2799, 2755, 2841, 2715,
        2895, 2699, 2870, 2664, 2837, 2608, 2825, 2562, 2837, 2519, 2839, 2490, 2877, 2396, 2919,
        2356, 2926, 2326, 2935, 2230, 2926, 2168, 2909, 2102, 2909, 2075, 2916, 2048, 2951, 1997,
        2984, 1986, 3012, 1986, 3036, 1981, 3045, 1954, 3054, 1885, 3071, 1855, 3080, 1828, 3099,
        1820, 3122, 1796, 3136, 1791, 3139, 1762, 3155, 1705, 3157, 1657, 3155, 1596, 3132, 1534,
        3113, 1475, 3078, 1427, 3052, 1411, 3033, 1389, 3022, 1328, 3019, 1258, 3033, 1178, 2989,
        1191
      ]
    },
    {
      "id": "kyushu",
      "points": [
        625, 3266, 599, 3247, 587, 3218, 573, 3194, 548, 3180, 520, 3178, 508, 3180, 463, 3205, 454,
        3231, 438, 3258, 417, 3266, 391, 3266, 382, 3271, 367, 3288, 332, 3298, 311, 3309, 318,
        3325, 314, 3341, 281, 3330, 272, 3330, 260, 3336, 253, 3362, 274, 3376, 304, 3405, 328,
        3421, 332, 3429, 349, 3467, 328, 3467, 311, 3456, 300, 3429, 276, 3411, 272, 3429, 274,
        3445, 279, 3459, 302, 3486, 311, 3499, 307, 3520, 297, 3542, 316, 3528, 339, 3502, 363,
        3488, 386, 3494, 396, 3504, 410, 3512, 421, 3515, 431, 3507, 435, 3491, 433, 3478, 428,
        3467, 417, 3462, 403, 3467, 393, 3467, 391, 3445, 391, 3424, 382, 3400, 407, 3379, 419,
        3387, 440, 3403, 454, 3440, 480, 3472, 484, 3499, 468, 3518, 482, 3526, 501, 3528, 482,
        3571, 459, 3614, 442, 3636, 426, 3657, 400, 3662, 396, 3670, 398, 3708, 400, 3735, 396,
        3756, 414, 3775, 426, 3802, 424, 3831, 419, 3842, 386, 3852, 398, 3885, 424, 3890, 489,
        3914, 501, 3890, 484, 3868, 475, 3839, 482, 3812, 494, 3783, 506, 3769, 534, 3772, 538,
        3783, 534, 3802, 515, 3807, 517, 3820, 531, 3860, 536, 3890, 529, 3919, 510, 3946, 513,
        3957, 562, 3933, 609, 3893, 595, 3860, 602, 3844, 618, 3844, 644, 3852, 665, 3855, 693,
        3783, 697, 3753, 693, 3727, 705, 3694, 709, 3662, 716, 3636, 728, 3606, 740, 3569, 756,
        3536, 815, 3470, 822, 3448, 798, 3435, 807, 3413, 784, 3395, 784, 3379, 796, 3360, 754,
        3360, 712, 3354, 730, 3322, 751, 3293, 754, 3279, 749, 3266, 735, 3255, 721, 3253, 702,
        3261, 683, 3271, 672, 3274, 658, 3274
      ]
    },
    {
      "id": "shikoku",
      "points": [
        1372, 3089, 1339, 3073, 1306, 3063, 1276, 3065, 1248, 3076, 1219, 3095, 1194, 3095, 1203,
        3124, 1201, 3140, 1189, 3154, 1163, 3167, 1135, 3164, 1123, 3167, 1098, 3178, 1084, 3178,
        1065, 3159, 1051, 3135, 1039, 3132, 1016, 3154, 1002, 3162, 995, 3183, 988, 3199, 983, 3215,
        969, 3242, 946, 3258, 906, 3290, 887, 3301, 845, 3322, 826, 3336, 840, 3336, 885, 3314, 906,
        3312, 915, 3312, 915, 3338, 925, 3346, 939, 3349, 939, 3370, 932, 3379, 932, 3392, 920,
        3411, 934, 3424, 936, 3448, 960, 3448, 985, 3453, 969, 3491, 981, 3486, 1006, 3494, 1023,
        3494, 1049, 3470, 1058, 3432, 1065, 3424, 1077, 3419, 1088, 3405, 1109, 3360, 1121, 3330,
        1201, 3290, 1215, 3288, 1252, 3296, 1278, 3306, 1315, 3349, 1329, 3360, 1336, 3333, 1343,
        3309, 1360, 3285, 1376, 3263, 1416, 3231, 1461, 3207, 1444, 3199, 1451, 3178, 1442, 3164,
        1437, 3148, 1437, 3097, 1404, 3103
      ]
    }
  ]
}
